--------------------------------------------------------------------------------------------------------------------------------------------------------------------------------------------------------
--------------------------------------------------------------------------------------------------------------------------------------------------------------------------------------------------------
--------------------------------------------------------------------------------------------------------------------------------------------------------------------------------------------------------
--------------------------------------------------------------------------------------------------------------------------------------------------------------------------------------------------------
--------------------------------------------------------------------------------------------------------------------------------------------------------------------------------------------------------
--------------------------------------------------------------------------------------------------------------------------------------------------------------------------------------------------------
---------B-------------------B----------T---B---------E-|---BB---B---BB-----E-B-----T---------|-B---B----X--------EB-M-------B--------------|-------B--?---B--------------------------------------------
-------T---X-----X-----------------------------B-----B---E-?-----T-----B---B--B----B------M------BB?--------X-----------------------------------------B---B|MB--T--B-?--------------------B-------B----v
--?T---|E----|---?-------------------------X-----------B-----T--T----?-X-----------------B-B------------?---B------B--B---E--------------B------------B-----B--M--T-B--T----------------M--B---?-------f
-----------?------------T--B------B--------M---------------|--------B-----B---T-----------------E-B-B----E-----------------------?------B--T-----E-------------------------E----T--B-------B---X--B----f
----------------B-E-------E----B--------?-----|B---------------B------B---B----|X---------------B--X------B------B--------M----E-------------------|------B--B--X--------X----------------------|------f
---------TB--------------------T------------------------E-------B-T---------------|E-----|B----------EB------------------|------T--XX----------------T---------BB-E-----------E----X---B----X-BB-------f
--X-------B----------B---------|--B--------------------E---T-------------B--------------B--------------XB-----------E----------------------?----------------------B---------------------------------E--f
-----?---------------B----------------B---B--------B--BE------T-----------------?-E---T-?------------------X------B------------------oB----?------T--------------B?------------M----------------E---|--f
m------------B----X--------------------------?E-----?-B-----------------------B-----E--------------E--------------?------?B|---X-----------B-B------?-------BBX------------------E-----?B--B------B----X
X-XX---X-X-X----X--X--X-XXXXX--XX-X--XX-XX-XXX---X--X-XX--XX-XXXXXX--XXXX---XX--XX--X---XX---X-----XXXXX-X--X--X-X--X---XX-XX-X-X-X-XX--XX-XXX-X---X--X-X--X---X------X----X-X-------XXX-XX-X-X-XX----XX
