-XXX------TX-|XX|---XX-|-|-|---XXX||----|T--X-||X-X----|-X|XX-|---X-XXX---|-||X-|XXX--------|-|--XXXX----|----X--X------X|---XX-|-|X----X|TX--|-X-X|X-XX--X--|-----T----X---|-----XX---X--XX-XX--||-----
-X|-XT-X-||-X-X|XXXXX|---X|-|XX-X---X----|-X-------X-T---X---X---XXX---|----|--|X--XX-XXXX-X---XX-X-X-XT--XXX---||---X--|-X--|------T-XX|-|X|-|--------XX--XX||X|-|||-X---|-X|XX--|-|XX|----|-----X---T-
-----|--XXXX-----------|-X-|X||--||-|T----T-XX-------|-|---|XX-|X-||TXT-T|--X-|XTX-----|--|XT--|-----X||--XX-X--X---X|T-|-XX|--XXX-|||X--X-|-X-|T-X-T|--X|-X|-XX----|X|-X|T|X|X-XX|X--|T--|X---|---X--|-
--------XX---X-X|XX-|--X---|X-|-|-|--|X---|-X--|-----T|-|XXX-|---XX-|||-|-------|----|X---X-|X-X--X-X---X-XXX---X---|-|-----X-X|X-----X--X---X--|---|---X|XX---||X-X------|-T----|---|X|-X-----X--X--X--
--X---X-----X---X--X-|X|------X-|XX--XX-|X|X|--|--XXX|-|--||-T-X|--X|----------X-X-------||--|--X-----X--XXX---XXX-X----|--T---|-|-----|-||X--||X---|-----XX-XXX|--X-X--|-|-|---XXT----X-TX--X----||----
-X|-X--XX---------X---|---|-T-|X--|||X-|X---|-|--XX------X|-X|XXT-X-----|X-X----XX-------T-X--|---T|--X--|X|-T---X-X|-X-|--|-----X-----X---X------|---|X--X--|---X|X----X-X-X-X|XX|-X----|---|--X-XX-|--
-|-||-X-XX-XXX--|-X--|-|-X|X|-X-X----|XXX-|-X-XX---XX--|----|-XX|X----|-X-|-XX-X-|-------|-----X--||-X--TX|--|-X--X-X|-|-----|-|-||XX|XX-XXX--|-|-X-|---X--|X---XX-X--X|X-X--|---XX-X----XX-------X---|-
--|---XX-X------X-TX--|----X-X-----|-X|-XX--|---X--------X-XXX----X----X-|--|--|--T---||---|-XX|---XXXX-|----|------|TXX--XX-|----XXX------T--|--X|--|--|X--X|--X|--|-|-|X|--||---|X--|-X-|--X-XX-X|---v
---X--------|X|---||---||--------X--TX-||---X---XX--||-X||X---X---X--X----X--X-X--|X----X--X---XX-|-X||T--|X-X|---|-X|-XTXX--|T--X|-|-X|--X|X-X|--|----X--|X|--T--X||X--|XX|-|--X------X-T|--X-X-XX-X-|f
-X--------X---||-|X--X-||X|XX-||----|X---||--------X-X--X--X-----X-|--X---||-|-X-XX-|X|--X|------XXX---|-T-----|XT||---|||||--|X------X---|--XX--X-----XXXX-T|-|--X-X-|X||-|--||||-X--X--||XXT||X|X----f
--XX----TXXX||T---|-X-X--X|X--X|-|-X-|-X-|XX-|-----|-XX---X---X-|T----X----|--X-TX|---|X--T---X----X---|-|-X--||||-X-|X-|-|--|--Xo---|X--|------|X--|XX-|X-||-----||-||-------T-X-T-X-X|-X||X|-XX|-X|-Xf
--X--X|-|||---|-X--X--|X-XX---|X-X--T--X--X--|----X|--X|||--|X---|------X-XX--|X|------X--||-||-||X-||-X---|-TX-X-X-XT-T--X-XX--|-T-------X---X-X--|--||-X-XX----------XX-X---|-X||XX-||--X-XX----X-X|Xf
-----|-X-|XX--|---XX-X|XT---|-|-----|-----||-X-----X--|||-|X----|----||---|-|--|-|XX-X-|||---------X---|T-X|-|-XXT---|-|---X-|----||XX-----X--X|--|X|-T----X--XX-------X---X-|--X|--XX|X-|X--||-XX---X|f
-XT---X--|--X|T-----T---|-X-X|XX-X--XX--|T---|X--X|XX--|X-TX---|-T-|----|------|---|-|-|X-----|--XX-----|TX------|X-|||---------|-----TX----|-----X---||---||||----TXXX-X--|-X||--X|?-|--T-|-------XT|-f
m-|----XX-----||X---|-X----||-X-----|X-|X|-----||-X-|--||X||-X-XX|-X--|--X--|o|--|X-----|-------X--X--X-X||X------|--XX|-|X-|-|-X--X--|--X-X-|X--|-|X---X-|-||-X---||--|-|||-|-X-||-X---X|-X--|X||--|--X
XXXXXXXXXXXXXXXXXXXXXXXXXXXXXXXXXXXXXXXXXXXXXXXXXXXXXXXXXXXXXXXXXXXXXXXXXXXXXXXXXXXXXXXXXXXXXXXXXXXXXXXXXXXXXXXXXXXXXXXXXXXXXXXXXXXXXXXXXXXXXXXXXXXXXXXXXXXXXXXXXXXXXXXXXXXXXXXXXXXXXXXXXXXXXXXXXXXXXXXX
